%%%%%%%%%%%%%%%%%%%%%%%%%%%%%%
% H%                         %
%  %                         %
%  %                         %
%  %                         %
%  %       ###               %
%         #####              %
%          ###               %
%               #            %
%            #  #     %####%%%
%            #  #     %####%%%
%            #  #     %# O#%%%
%            #  %     %%%%%%#%
%            #  %            %
%%%%%%%%%%%%%%%%%%%%%%%%%%%%%%