%%%%%%%%%%%%%%%%%%%%%%%%%%%%%%
%  ##  ### ### ### ### ###   %
%   %%  %     %%       %  ###%
%  %    %     %%      %%% ###%
% H%  ##%     ####%%   %  ###%
% ######%%%%##### %%####  ###%
%        %            %%  ###%
%##%     %     %%    %%%% ###%
%## %   %%%%     ###  %%  ###%
%## %          %    #        %
%##    %       %  # %    %%%%%
%##    %%%%    %  #%%% # % O %
%##  ###  ###  %  # %    %%##%
%                            %
%%%%%%%%%%%%%%%%%%%%%%%%%%%%%%